project_title	Avyaan
project_short_name	Avyaan
project_description	Avyaan Technologies
site_name	Avyaan.tech
site_domain	avyaan.tech
base_url	https://avyaan.tech
version	1.0.0
author	Avyaan Technologies
twitter_owner	_
twitter_author	_
fb_version	
fb_appId	_
fb_admins	_
google_analytics_id	UA-_-_
google_cse_id	_
sentry_key	_
sentry_id	_
sentry_version	_
sentry_hash	_
google_adsense_ad_client	_
